
NO           ./map/texture1.xpm
SO ./map/texture2.xpm
EA							./map/texture51.xpm
WE ./map/texture52.xpm

F 37,4,61
C 26,160,249

1111111111111111111111111111111111
1000000000000000000000000000000111
1000000000011000001110000000000001
1111111111001000000000000000011111
1111111110110000011100000W0000001
100000000011000001110111111D11111
11110111111111011100000010001
11110111111111011101010010001
11000000110101011100000010001
100000000000000110000001000111
100000000000000011010100000001
110000011101010111110111100011
11110111 1110101 101111010001
11111111 1111111 111111111111
