
F 66,66,66
C 0,0,255

NO           ./map/texture1.xpm
SO ./map/texture2.xpm
EA							./map/texture51.xpm
WE ./map/texture52.xpm


1111111111111111111111111111111111
1000000000000000000110000000000001
1000000000011000001110000000000001
111111111100100000000000000000001
111111111011000001110000000000001
100000000011000001110111111D11111
1111011111111101110000001S001
11110111111111011101010010001
11000000110101011100000010001
10000000000000001100000010001
100000000000000011010100000001
110000011101010111110111100011111
11110111 1110101 101111010001
11111111 1111111 111111111111
