

F 64,52,000


NO           ./map/texture1.xpm
SO ./map/texture2.xpm
EA							./map/texture51.xpm
WE ./map/texture52.xpm

C 183,52,000

1111111
1001ND00
1000111
100001
111111
